20 15
####################
#         #        #
#         #    #   #
#         #    ## ##
#         ######   #
#                  #
#   #              #
#    #             #
#     #            #
#      #           #
#       ############
#             #    #
#         #        #
#         #        #
####################
